1 6 728 845 4180 2038 1477 2527 
1 7 2527 1569 364 4217 2883 4222 8774 
1 3 8774 8786 8779 
1 14 4340 8800 8802 3134 809 8803 8804 8805 4272 4253 4230 2238 8826 2232 
1 5 4230 3065 4241 1929 2804 
1 3 4272 4262 2524 
1 5 4264 2752 4252 4238 8773 
1 3 8773 8786 8779 
1 4 8824 8765 1494 4264 
1 5 8824 4318 4317 8823 8755 
1 4 4317 1197 8788 2118 
1 5 8823 4306 4289 8768 880 
1 5 2524 2307 3036 8764 8823 
1 3 8768 8770 2118 
1 3 4240 4243 2524 
1 3 4243 8776 2111 
1 4 4188 1926 4208 2111 
1 2 2111 4176 
1 3 8814 1952 4176 
1 2 4176 2411 
1 3 8812 4181 2411 
1 2 8812 1958 
1 3 4175 4173 1958 
1 4 8781 4185 1619 4173 
1 2 4173 4155 
1 2 8779 8778 
1 2 1958 4214 
1 4 4214 2602 1740 8778 
1 3 4214 4225 1170 
1 2 2118 8825 
1 3 2118 4264 1170 
1 3 8768 4265 2143 
1 3 2143 8825 1170 
1 3 2143 8806 880 
1 3 8806 1005 8812 
1 3 8806 8810 2111 
1 5 2524 4266 4278 8768 880 
1 2 880 4278 
1 3 8800 8801 2935 
1 7 2935 4324 4315 4329 2978 8759 8757 
1 2 8757 8756 
1 2 4340 4348 
1 2 8758 8755 
2 9 8758 8753 8743 8746 8740 4353 8737 8734 8729 
1 4 366 1053 90 4664 
1 2 4664 1093 
1 2 8735 8737 
1 3 205 4344 8743 
1 6 1661 8728 8732 8736 2545 205 
1 9 2269 2352 1532 1129 4521 4525 4522 2512 2341 
2 4 2269 4519 4515 207 
2 7 8729 1334 2028 1965 736 1999 207 
1 3 366 2492 2269 
1 6 2269 2034 4523 691 2075 382 
1 2 382 72 
1 2 55 382 
1 2 49 72 
2 2 2255 2010 
2 5 2010 1900 4657 2613 1858 
2 4 2740 1628 2452 1858 
1 2 1922 2452 
2 12 2740 4644 3099 1687 2092 4605 4597 4596 4587 464 4591 2417 
1 2 4615 1687 
1 6 2613 4689 2267 2697 2853 110 
1 2 1272 4587 
1 4 4945 22 361 4933 
1 3 2198 1249 4933 
1 14 2471 2979 964 4896 3080 2358 4897 4902 1248 2186 229 4913 4923 4933 
1 4 4871 4873 1697 2471 
1 4 4873 1448 2700 995 
1 14 2186 4891 4884 1567 4868 2397 4862 4860 4853 4849 4841 2557 4830 2509 
1 4 995 4850 170 2509 
1 6 995 1022 2622 258 3061 1333 
1 8 2509 4821 717 2191 4807 2268 2331 4768 
3 5 4674 2388 2007 2308 4768 
1 4 4674 1959 4655 2768 
1 4 4655 508 2373 4640 
1 3 4640 2404 2737 
1 6 4640 1609 2106 713 896 4714 
1 3 4714 965 65 
1 5 4768 4773 65 4793 1665 
1 4 4793 4805 1872 1333 
3 7 4674 4662 2678 4658 4671 327 2740 
1 3 2089 1782 3355 
1 6 3121 2171 3399 3384 88 3355 
1 5 3121 1483 3365 2664 2089 
1 6 1593 1204 3327 1472 3073 1159 
1 2 1593 2403 
2 7 1159 773 1590 2844 1458 30 611 
1 3 773 1856 376 
1 4 611 1525 3225 700 
3 2 611 8603 
1 3 8603 1914 3178 
2 4 8603 849 549 847 
2 8 847 2640 1362 1432 1746 125 1548 2051 
2 3 2051 2900 1237 
1 2 1237 3168 
2 6 8614 1795 2854 3175 3179 3171 
2 4 901 3170 467 3171 
2 6 901 3162 1239 3169 3165 3168 
1 2 3162 433 
1 2 266 3165 
4 2 8614 8612 
1 9 8612 8610 1734 7999 1683 3223 260 3252 1783 
1 2 7999 3204 
1 7 3462 3445 3429 2429 529 3427 2646 
1 8 3427 279 1823 3358 1288 2278 2760 3362 
1 4 1288 2936 2499 305 
1 2 305 342 
1 4 3447 3432 3418 3429 
1 8 224 1518 3419 2026 1016 694 2532 3418 
1 2 694 3392 
1 4 1016 3398 89 3375 
1 7 1518 381 1340 3465 3439 931 1311 
1 7 2804 4231 1787 535 2399 2648 4194 
4 6 8661 8659 3003 1739 8666 8670 
3 3 1739 8657 2346 
3 3 8666 8667 8665 
1 2 8665 3003 
3 4 8670 8671 8672 8665 
1 2 8665 8672 
4 6 8672 8673 4064 2736 2751 8675 
2 3 8675 8677 1193 
2 5 2736 4012 4010 1989 155 
1 3 1193 3985 4010 
2 3 2346 8655 8643 
4 6 8661 8659 2304 4138 1052 4187 
1 2 8657 4138 
1 3 8643 8637 1052 
1 3 107 1191 4187 
2 4 4187 894 4226 2796 
2 4 2796 8628 8626 4297 
3 7 4297 8624 578 8621 8618 8617 8616 
1 6 4187 8633 8631 8630 8629 4194 
2 13 4194 8638 8640 8642 8645 8646 8648 8649 8650 8651 8652 8653 2346 
1 5 8643 8635 4177 4198 8629 
1 5 8630 4215 4235 8627 8626 
1 5 107 1855 4189 4206 4226 
3 7 8660 8662 1097 4099 1262 4055 2736 
2 4 4055 4060 4033 4010 
3 4 4099 8669 8668 8665 
3 4 8660 3116 8654 2251 
1 3 3116 4161 107 
2 3 3116 4131 1126 
1 4 4060 4084 2855 1126 
